5 1 1 1 0 4 0 0 0 4 0 0 0 0 4 0 0 0 0 4 0 1 1 1 4 5 2 2 2 2
4 1 1 1 1 1 1 1 1 1 1 1 1 1 1 1 1 1 1 1 1 1 1 1 0 4 2 2 2 2
0 1 1 1 0 5 0 0 0 4 0 0 0 0 4 0 4 0 5 0 4 1 1 1 5 0 2 2 2 2
5 0 1 4 0 0 4 0 0 0 0 0 0 0 0 0 0 0 0 4 0 0 1 0 0 4 2 2 2 2
4 0 1 0 0 0 0 0 0 0 0 0 0 0 0 0 0 0 0 0 0 4 1 4 0 0 2 2 2 2
0 0 1 4 0 0 0 0 0 0 4 0 0 0 0 0 0 0 0 4 0 5 1 0 0 5 2 2 2 2
0 4 1 0 0 0 0 4 0 0 0 0 0 0 4 0 0 0 0 0 0 4 1 0 4 0 2 2 2 2
5 0 1 0 0 0 0 0 0 0 0 4 0 0 0 0 4 0 0 0 0 0 1 0 0 4 2 2 2 2
4 0 1 0 0 5 0 0 4 0 0 0 0 0 0 0 0 0 0 0 0 0 1 4 0 5 2 2 2 2
0 4 1 0 0 0 4 0 0 0 0 0 0 0 0 0 0 0 0 4 0 0 1 0 0 0 2 2 2 2
0 0 1 0 0 0 0 0 0 0 0 0 0 0 0 0 0 0 0 0 0 0 1 4 4 0 2 2 2 2
4 0 1 0 0 0 0 0 0 0 0 0 0 0 0 0 0 0 0 0 0 4 1 0 0 4 2 2 2 2
0 0 1 0 4 0 0 0 0 4 0 0 4 0 0 0 0 0 0 0 4 0 1 0 5 0 2 2 2 2
0 4 1 0 0 0 4 0 4 0 0 0 0 0 0 0 0 0 0 0 0 4 1 5 0 4 2 2 2 2
0 5 1 0 0 0 0 0 0 0 4 0 0 0 0 0 0 0 4 0 0 0 1 0 0 4 2 2 2 2
4 0 1 5 0 0 0 0 0 0 0 0 0 0 0 0 0 0 0 4 0 0 1 0 0 0 2 2 2 2
5 0 1 0 0 0 0 0 4 0 0 0 0 0 0 0 0 0 0 0 0 0 1 0 4 0 2 2 2 2
0 1 1 1 0 0 0 4 0 0 4 0 0 0 4 0 5 0 0 0 0 1 1 1 0 0 2 2 2 2
5 1 1 1 1 1 1 1 1 1 1 1 1 1 1 1 1 1 1 1 1 1 1 1 0 4 2 2 2 2
4 1 1 1 0 0 4 0 0 0 0 0 4 0 0 0 0 0 4 0 0 1 1 1 0 0 2 2 2 2